res/tiles/cave.png
1 2 2 2 2 2 2 2 2 2 2 2 2 2 2 2 2 2 2 3
9 10 10 10 10 10 10 10 10 10 10 8 10 10 10 10 10 10 6 11
9 10 10 8 10 10 8 10 10 6 10 10 10 6 10 10 6 10 10 11
17 18 18 18 18 18 18 18 18 18 18 18 18 18 18 18 18 18 18 19
0 24 0 0 0 13 0 0 13 0 0 24 0 0 0 0 0 0 0 0
0 0 0 0 0 21 0 0 13 0 0 0 0 0 0 0 0 0 0 0
0 0 0 0 0 0 0 0 21 0 0 0 0 0 0 0 0 0 0 0
0 0 0 0 0 0 0 0 0 0 0 0 0 0 1 3 0 0 0 0
0 0 0 0 0 0 0 0 0 0 0 0 0 0 9 11 0 0 0 0
0 0 0 0 0 0 0 0 0 0 0 0 0 0 9 11 0 0 0 0
0 0 0 0 0 0 0 0 0 0 0 0 0 0 9 11 0 0 0 0
1 2 2 2 2 2 2 2 2 2 2 2 2 2 8 6 2 2 2 3
9 10 10 7 10 10 10 10 10 10 10 10 7 10 10 10 10 10 10 11
9 10 7 10 10 10 7 10 10 7 10 10 10 10 8 10 10 10 10 11
9 10 10 7 10 10 10 10 10 10 10 7 10 10 10 10 10 8 10 11