res/tiles/cave.png
0 0 0 0 0 0 0 0 0 0 0 0 0 0 0 0 0 0 0 0 0 0 0 0 0 0 0 0 0 0 0 0 0 0 0 0 0 0 0 0 0 0 0 0 0 0 0 0 0 0 0 0 0 0 0 0 0 0 0 0 0 0 0 0 0 0 0 0 0 0 0 0 0 0 0 0 0 0 0 0 0 0 0 0 0 0 0 0 0 0 0 0 0 0 0 0 0 0 0 0
0 0 0 0 0 0 0 0 0 0 0 0 0 0 0 0 0 0 0 0 0 0 0 0 0 0 0 0 0 0 0 0 0 0 0 0 0 0 0 0 0 0 0 0 0 0 0 0 0 0 0 0 0 0 0 0 0 0 0 0 0 0 0 0 0 0 0 0 0 0 24 0 24 0 0 0 0 0 0 0 0 0 0 0 0 0 0 0 0 0 0 0 0 0 0 0 0 0 0 0
0 0 0 0 0 0 0 0 0 0 0 0 0 0 0 0 0 0 0 0 0 0 0 0 0 0 0 0 0 0 0 0 0 0 0 0 0 0 0 0 0 0 0 24 24 0 0 0 24 0 24 24 0 24 24 0 0 0 0 0 0 0 24 0 0 0 0 0 0 0 0 12 0 24 0 0 0 24 0 0 0 0 0 24 0 0 0 0 0 24 0 0 0 24 0 0 0 0 0 0
0 0 0 0 0 0 0 0 0 0 0 0 0 0 0 0 0 0 0 0 0 0 0 0 0 0 0 0 0 0 0 0 0 0 0 24 0 0 0 0 0 0 0 0 0 0 0 0 0 0 0 0 0 0 0 0 0 0 16 0 0 0 0 0 0 0 0 0 0 0 0 4 0 0 0 0 16 0 0 0 0 0 0 0 0 0 0 0 0 0 0 0 0 0 0 0 0 0 0 0
24 0 0 0 0 0 24 0 24 0 0 0 0 0 0 0 24 0 0 0 0 0 24 0 0 0 0 0 0 24 0 0 24 0 0 0 0 0 0 14 0 0 0 16 16 0 16 16 0 16 16 0 0 14 0 0 0 0 0 0 0 0 0 0 0 0 0 0 0 0 0 0 0 0 0 0 16 0 0 16 0 0 0 0 0 0 0 0 0 0 0 0 0 0 0 14 16 16 0 0
0 15 0 0 15 0 0 0 0 0 0 0 15 0 0 0 0 0 14 16 0 0 0 0 0 0 0 0 14 0 0 16 16 16 0 0 0 0 0 0 0 0 0 0 16 0 0 0 0 0 0 0 0 0 0 0 0 0 0 0 0 0 0 0 0 0 0 0 0 14 16 0 0 0 0 0 0 0 0 0 0 0 0 16 0 0 0 0 14 0 0 0 0 0 0 0 0 0 0 0
0 0 16 15 0 0 0 0 0 0 23 0 0 0 0 0 0 0 0 0 0 0 16 0 0 0 0 0 0 0 0 0 0 22 0 0 0 0 0 0 0 0 0 0 0 0 0 0 0 0 16 0 0 0 16 0 0 0 0 0 14 0 0 0 0 0 0 0 0 0 0 0 0 0 0 0 0 16 0 0 0 0 0 0 0 0 0 0 0 0 0 0 0 0 0 0 0 0 0 0
0 0 0 16 0 15 15 0 0 0 0 0 0 0 0 15 0 0 0 0 0 0 16 16 0 24 0 0 0 0 0 0 0 0 0 0 0 16 16 16 0 0 0 0 0 0 0 0 0 16 16 0 0 0 0 0 0 0 0 0 0 0 0 0 0 0 0 0 0 0 0 0 0 0 0 0 0 0 0 14 0 0 0 0 0 0 0 0 0 0 0 0 0 0 0 0 0 0 0 0
0 0 0 16 0 0 0 0 15 0 16 0 0 0 0 0 0 0 0 15 0 0 0 16 0 0 24 0 0 14 0 0 16 16 16 16 0 0 16 16 16 16 16 16 0 0 16 0 0 16 0 0 0 0 0 0 16 0 0 0 0 0 0 22 22 22 0 0 0 22 22 0 0 22 0 0 0 0 0 22 22 0 0 22 0 0 0 22 0 0 0 0 0 0 0 0 0 0 0 0
0 0 0 15 0 0 0 0 15 0 0 0 0 0 0 0 0 0 0 0 0 0 0 0 0 0 0 14 0 0 0 22 16 0 0 0 0 0 0 0 0 0 14 0 0 0 16 0 0 0 0 0 14 0 0 0 0 0 0 0 0 0 0 0 0 0 0 16 0 0 16 16 16 16 0 0 0 0 0 0 0 0 0 0 0 0 0 0 0 0 0 0 0 0 0 0 0 0 0 0
0 0 22 0 0 0 22 0 0 0 0 0 0 0 22 0 0 22 0 0 23 0 0 0 0 0 0 22 0 0 22 0 0 16 24 0 0 16 16 16 16 0 0 0 0 16 0 0 0 0 0 0 0 0 0 0 22 0 0 16 0 0 0 0 0 0 0 0 16 0 0 16 0 0 0 0 0 22 0 0 0 0 0 0 16 0 0 0 0 16 0 0 0 16 0 0 16 0 16 0
0 0 0 0 0 0 0 0 0 16 0 16 0 0 0 0 0 0 0 0 0 0 0 16 0 0 0 0 0 0 16 16 0 0 0 0 0 16 16 0 0 0 0 0 0 0 0 0 0 0 0 22 22 0 0 0 16 0 0 16 0 0 0 0 24 0 0 16 0 0 16 16 16 0 0 0 0 0 0 0 0 0 16 0 0 0 0 0 0 0 0 0 0 0 0 0 0 0 16 0
0 0 16 0 0 0 0 16 0 0 0 0 0 0 0 0 16 0 0 16 0 0 0 0 0 16 16 0 0 0 0 0 24 24 0 0 0 16 0 0 0 16 0 22 0 22 0 0 14 0 0 16 0 0 16 0 0 0 16 0 0 0 22 0 22 0 16 16 0 0 0 0 0 22 0 0 22 0 0 16 0 16 0 0 0 0 16 0 0 0 0 16 0 0 16 0 0 0 16 0
0 0 0 16 0 0 0 16 0 0 0 16 0 0 0 0 16 0 0 16 0 24 0 14 0 0 0 24 24 24 24 24 0 0 0 0 0 0 0 0 0 0 0 0 16 0 0 0 0 0 0 0 16 0 0 0 16 0 0 0 0 0 0 0 0 0 0 0 0 0 0 0 0 0 0 0 0 0 0 0 0 0 0 16 0 0 0 0 16 0 0 0 0 0 0 16 0 16 0 0
0 0 0 0 0 0 0 0 0 0 0 0 0 0 0 0 0 0 0 0 0 0 0 0 0 0 0 0 0 0 0 0 0 0 0 0 0 0 0 0 0 0 0 0 0 16 16 0 0 0 0 0 0 0 0 0 0 0 0 0 0 0 0 16 0 0 0 16 0 0 0 16 16 0 0 0 0 0 0 0 0 0 0 0 0 0 0 0 0 0 0 0 0 0 0 0 0 0 0 0
